product	ORGANIZATION,
sparrow	PERSON,
newport	LOCATION,
indonesia	LOCATION,
ric	PERSON,
cheno	LOCATION,
bantz	PERSON,
roll	ORGANIZATION,
marc	PERSON,
powel	PERSON,
africa	LOCATION,
irfan	LOCATION,
golf	ORGANIZATION,
diamond	PERSON,
tich	PERSON,
kim	PERSON,
diego	LOCATION,
kirk	PERSON,ORGANIZATION,
barbara	PERSON,
isabella	PERSON,
corey	PERSON,
imma	PERSON,
kathem	PERSON,
dexter	PERSON,
funni	ORGANIZATION,
kenylah	PERSON,
robinson	PERSON,
malcolm	PERSON,
oakland	LOCATION,
trevor	PERSON,
troy	PERSON,
berni	PERSON,
yves	ORGANIZATION,
brittney	PERSON,
anni	PERSON,
turner	PERSON,ORGANIZATION,
fortune-monica-fr	PERSON,
trendi	ORGANIZATION,
solid	ORGANIZATION,
mgk	ORGANIZATION,
saron	ORGANIZATION,
reddit	LOCATION,
teal	PERSON,
pippin	ORGANIZATION,
kristina	PERSON,
hooray	PERSON,
edc	ORGANIZATION,
isreal	LOCATION,
gate	PERSON,
hermion	PERSON,
catalonia	LOCATION,
schneider	PERSON,
nick	PERSON,
bruce	PERSON,
bill	PERSON,
lock	PERSON,
hondura	LOCATION,
mumford	PERSON,
sydney	LOCATION,
john	PERSON,ORGANIZATION,
songz	PERSON,
clark	PERSON,
hash	PERSON,
drake	PERSON,
masquerad	ORGANIZATION,
hanoi	LOCATION,
tara	ORGANIZATION,
armi	ORGANIZATION,
knoeckel	PERSON,
brahim	PERSON,
minor	PERSON,
abort	ORGANIZATION,
costello	PERSON,
rutley	PERSON,
portilla	ORGANIZATION,
collin	PERSON,
zendaya	PERSON,
waffl	ORGANIZATION,
talbott	PERSON,
tribbett	PERSON,
khale	ORGANIZATION,
toronto	LOCATION,
wollongong	LOCATION,
6th	ORGANIZATION,
tabulaa	LOCATION,
ralph	PERSON,
dc	LOCATION,
nij	ORGANIZATION,
ft	ORGANIZATION,
wall	ORGANIZATION,
degraw	PERSON,
's	ORGANIZATION,
colorado	LOCATION,
ingram	PERSON,
craig	PERSON,
boo	PERSON,
griff	PERSON,
park	LOCATION,
nigga	PERSON,
sheldon	PERSON,
parkour	PERSON,
leviosa	PERSON,
kfc	ORGANIZATION,
julian	PERSON,
sear	ORGANIZATION,
hodaidah	LOCATION,
tianjin	LOCATION,
udc	ORGANIZATION,
guccimichael	PERSON,
cambria	LOCATION,
kiwi	PERSON,
ranger	ORGANIZATION,
fuk	PERSON,
orlean	LOCATION,ORGANIZATION,
wnan	PERSON,
veronica	PERSON,
nam	ORGANIZATION,
blacklight	ORGANIZATION,
preashea	PERSON,
kuwait	LOCATION,
f.	PERSON,
bugg	PERSON,
wray	PERSON,
brb	PERSON,
jamal	PERSON,
jack	PERSON,
g.	PERSON,
joseph	LOCATION,
holm	PERSON,
senor	ORGANIZATION,
bo	ORGANIZATION,
lukasiak	PERSON,
cece	PERSON,
boat	ORGANIZATION,
dawn	PERSON,
jamin	PERSON,
figoli	PERSON,
thick	PERSON,
coast	LOCATION,
mineo	PERSON,
mark	PERSON,ORGANIZATION,
rob	PERSON,
hilliard	PERSON,
lori	PERSON,
amazon	ORGANIZATION,LOCATION,
jordan	PERSON,LOCATION,
haha	PERSON,
gild	ORGANIZATION,
pretoria	LOCATION,
harold	PERSON,
briannnnnaaa	PERSON,
panda	PERSON,
at	ORGANIZATION,
center	ORGANIZATION,
imi	ORGANIZATION,
arco	ORGANIZATION,
post	ORGANIZATION,
ava	PERSON,
ashley	PERSON,
non	ORGANIZATION,
chevi	ORGANIZATION,
blade	PERSON,
good	PERSON,
zuckerberg	PERSON,
taylor	PERSON,
de	ORGANIZATION,
googl	ORGANIZATION,
joscelyn	PERSON,
l.	PERSON,
fina	ORGANIZATION,
siddhi	PERSON,
spragg	PERSON,
darrel	PERSON,
tyler	PERSON,
lacomb	PERSON,
netflix	ORGANIZATION,
linda	PERSON,ORGANIZATION,
samba	ORGANIZATION,
block	ORGANIZATION,
thoma	PERSON,
deser	PERSON,
david	PERSON,ORGANIZATION,
alesso	LOCATION,
jamei	PERSON,
wooohoooooo	PERSON,
hous	ORGANIZATION,
sakit	PERSON,
bethanymota	PERSON,
haddington	LOCATION,
middletown	LOCATION,
chan	PERSON,
centr	LOCATION,
clifford	PERSON,
ln	ORGANIZATION,
cendana	LOCATION,
franc	LOCATION,
maui	LOCATION,
jennif	PERSON,
nite	ORGANIZATION,
gim	PERSON,
anthoni	PERSON,
mpumalanga	LOCATION,
terrio	PERSON,
itali	LOCATION,
dmx	ORGANIZATION,
pridemor	PERSON,
fingerless	ORGANIZATION,
choir	ORGANIZATION,
ty	PERSON,
lauren	PERSON,ORGANIZATION,
kaulah	PERSON,
hill	ORGANIZATION,
mullin	PERSON,
tasha	PERSON,
charlottesvill	LOCATION,
gunther	PERSON,
rene	PERSON,
xavier	PERSON,
j.	PERSON,
lackey	PERSON,
london	LOCATION,
chaka	PERSON,
geek	ORGANIZATION,
boston	ORGANIZATION,LOCATION,
mccaul	PERSON,
basto	LOCATION,ORGANIZATION,
pioneer	LOCATION,
rubidilaik	PERSON,
sinead	PERSON,
moeski	PERSON,
jupit	ORGANIZATION,
skecher	ORGANIZATION,
dando	PERSON,
affleck	PERSON,
swoop	ORGANIZATION,
hudson	LOCATION,
lindsay	PERSON,
syke	PERSON,
josh	PERSON,
sheraton	ORGANIZATION,
saintslyssa	PERSON,
jenkins-fellowship	PERSON,
switzerland	LOCATION,
fanfar	ORGANIZATION,
marilyn	PERSON,
bogo	ORGANIZATION,
colleg	ORGANIZATION,
up	ORGANIZATION,
spivey	PERSON,ORGANIZATION,
frank	PERSON,
faith	PERSON,
linen	ORGANIZATION,
sox	ORGANIZATION,
bois	ORGANIZATION,
burdi	ORGANIZATION,
byron	PERSON,
lebanon	LOCATION,
bayonetta	ORGANIZATION,
sanfrancisco	LOCATION,ORGANIZATION,
alunageorg	PERSON,
scotland	LOCATION,
stamko	PERSON,
naral	ORGANIZATION,
gore	PERSON,
reeg	PERSON,
facebook	ORGANIZATION,
naython	PERSON,
myron	PERSON,
saudi	LOCATION,
prada	PERSON,
elementari	ORGANIZATION,
stop	ORGANIZATION,
hudgin	PERSON,
sabbath	LOCATION,
mccartney	PERSON,
zeppelin	ORGANIZATION,
torpedo	ORGANIZATION,
haddon	PERSON,
ronni	PERSON,
riley	PERSON,
bobo	ORGANIZATION,
garvey	PERSON,
dian	PERSON,
alysaunderss	PERSON,
peyton	PERSON,
amman	LOCATION,
stichpattern	PERSON,
showalt	PERSON,
ethan	PERSON,
adamson	PERSON,
gallagh	ORGANIZATION,
mountain	LOCATION,
ross	PERSON,
mario	PERSON,
missisippi	ORGANIZATION,
vonfurstenburg	PERSON,
young	PERSON,
roffman	PERSON,
pusheen	PERSON,
stewart	PERSON,
news	ORGANIZATION,
natalia	PERSON,
cheshir	LOCATION,
court	PERSON,ORGANIZATION,
hin	ORGANIZATION,
rock	PERSON,ORGANIZATION,
bieber	PERSON,
halloway	PERSON,
terri	PERSON,
minsk	LOCATION,
espnnfl	ORGANIZATION,
carre	PERSON,
caleb	PERSON,
arnold	PERSON,
eliza	PERSON,
wizard	ORGANIZATION,
van	PERSON,
raw	ORGANIZATION,
kenni	PERSON,
keiara	ORGANIZATION,
kensington	LOCATION,
shes	PERSON,
glove	ORGANIZATION,
terresa	PERSON,
moro	PERSON,
luci	PERSON,
vaughan	PERSON,
jaim	PERSON,
loud	ORGANIZATION,
israel	LOCATION,
memphi	LOCATION,
sayulita	LOCATION,
khan	PERSON,
whitney	PERSON,
mckee	PERSON,
druitt	ORGANIZATION,
drakebel	PERSON,
card	ORGANIZATION,
nova	PERSON,
morski	PERSON,
alaska	LOCATION,
denver	LOCATION,
mcdonald	PERSON,ORGANIZATION,
papa	PERSON,
kate	PERSON,
hospit	ORGANIZATION,
diao	PERSON,
air	ORGANIZATION,
wilson	PERSON,
costco	ORGANIZATION,
lush	PERSON,
goldroom	LOCATION,
zmg	ORGANIZATION,
michell	PERSON,
kany	LOCATION,
forest	ORGANIZATION,
indio	LOCATION,
rwbi	ORGANIZATION,
mike	PERSON,
brother	ORGANIZATION,
hamilton	PERSON,
alan	PERSON,
vooza	LOCATION,
yee	PERSON,
cathi	ORGANIZATION,
yolo	ORGANIZATION,LOCATION,
san	PERSON,LOCATION,
amp	ORGANIZATION,
burrr	LOCATION,
carmel	LOCATION,
energi	ORGANIZATION,
trev	PERSON,
green	PERSON,
dumar	PERSON,
dancarey	PERSON,
ramon	PERSON,
beleaf	PERSON,
shae	PERSON,
mckeon	PERSON,
adweek	ORGANIZATION,
coe	PERSON,
steenkamp	PERSON,
lockhart	PERSON,
punish	PERSON,
obama	PERSON,
idlewild	LOCATION,
frick	PERSON,
harlem	LOCATION,
reezthecollag	LOCATION,
fallin	PERSON,
sherlock	PERSON,
barb	PERSON,
selah	PERSON,
viktori	PERSON,
ganley	PERSON,
coldplay	ORGANIZATION,
mbele	PERSON,
patric	PERSON,
kidkabar	PERSON,
jean	PERSON,
showtek	ORGANIZATION,
germani	LOCATION,
michela	PERSON,
black	PERSON,ORGANIZATION,LOCATION,
michael	PERSON,
wittenberg	LOCATION,
funniest	ORGANIZATION,
knick	ORGANIZATION,
reec	PERSON,
bigg	PERSON,
liz	PERSON,
yard	ORGANIZATION,
spca	ORGANIZATION,
jovi	LOCATION,
reuter	ORGANIZATION,
wild	PERSON,
jerusalem	LOCATION,
chubbi	PERSON,
first	ORGANIZATION,
texa	LOCATION,ORGANIZATION,
pari	LOCATION,
rebel	ORGANIZATION,
sam	PERSON,
rozalla	LOCATION,
aruba	LOCATION,
vega	PERSON,LOCATION,
alic	PERSON,
glover	LOCATION,
mallorca	LOCATION,
creek	LOCATION,
o'shea	PERSON,
abbi	PERSON,
armor	ORGANIZATION,
vanessa	PERSON,
becki	PERSON,
franklin	PERSON,
gerard	PERSON,
campbel	PERSON,ORGANIZATION,
gell	PERSON,
drinkin	PERSON,
audi	ORGANIZATION,
pictur	ORGANIZATION,
morrow	PERSON,
leonard	PERSON,
saxton	PERSON,
tee-wyla	LOCATION,
miami	LOCATION,
canon	ORGANIZATION,
montabaur	LOCATION,
doorn	PERSON,
gaug	ORGANIZATION,
haim	PERSON,
boyziimen	PERSON,
bryon	PERSON,
mane	PERSON,
dalla	LOCATION,
michealburt	PERSON,
central	LOCATION,
kayano	PERSON,
strummer	PERSON,
facetim	ORGANIZATION,
bungl	PERSON,
england	LOCATION,
garrix	PERSON,
putney	ORGANIZATION,
kee	PERSON,
lynn	PERSON,
part	ORGANIZATION,
marlo	PERSON,
deepbeat	ORGANIZATION,
labrecqu	PERSON,
arsenicmagazin	ORGANIZATION,
suzi	PERSON,
netherworld	LOCATION,
atc	ORGANIZATION,
major	ORGANIZATION,
mundi	PERSON,
gulati	PERSON,
were	ORGANIZATION,
claridgechri	PERSON,
libertarian	ORGANIZATION,
noor	ORGANIZATION,
cowboy	ORGANIZATION,
rhys	PERSON,
fedel	PERSON,
rick	PERSON,
con	ORGANIZATION,
jonesdr	PERSON,
struttin	PERSON,
farmeri	PERSON,
jonni	PERSON,
bernhoft	PERSON,
bridg	ORGANIZATION,
anis	ORGANIZATION,
davison	PERSON,
reppin	PERSON,
kash	LOCATION,
putin	PERSON,
stockton	PERSON,
rider	PERSON,
beamer	PERSON,
jax	PERSON,
caledonia	LOCATION,
lynch	PERSON,
mississippi	LOCATION,
mariska	PERSON,
trey	PERSON,
kelli	PERSON,
ireland	LOCATION,
chanel	ORGANIZATION,
cline	PERSON,
ron	PERSON,
royal	ORGANIZATION,
lon	PERSON,
washington	ORGANIZATION,
brooklyn	LOCATION,
lopan	LOCATION,
cullum	PERSON,
mcdowel	PERSON,
nanci	PERSON,
welch	PERSON,
muzi	PERSON,
chloe	PERSON,
jasmin	PERSON,ORGANIZATION,
maggi	PERSON,
summer	PERSON,
otr	ORGANIZATION,
grand	ORGANIZATION,
butler	PERSON,
lee	PERSON,ORGANIZATION,
boi	ORGANIZATION,
book	ORGANIZATION,
shrc	ORGANIZATION,
brandon	PERSON,
fan	ORGANIZATION,
japon	PERSON,
doolittl	PERSON,
nablus	LOCATION,
savannah	LOCATION,
firefox	ORGANIZATION,
nba	ORGANIZATION,
boulevard	ORGANIZATION,
richardson	PERSON,
ap	ORGANIZATION,
jamiroquai	PERSON,
ebola	LOCATION,
nero	PERSON,
hati	PERSON,
lanc	PERSON,
bristol	LOCATION,
dubz	PERSON,
calandra	PERSON,
breyonc	PERSON,
feat	PERSON,ORGANIZATION,
lil	PERSON,LOCATION,
wolfpack	ORGANIZATION,
krewella	LOCATION,
murray	PERSON,
imag	ORGANIZATION,
zara	PERSON,
puma	ORGANIZATION,
oregon	LOCATION,
bella	ORGANIZATION,
rockstar	ORGANIZATION,
rundgren	PERSON,
hank	PERSON,
barcelona	LOCATION,ORGANIZATION,
kiki	PERSON,
ballin	PERSON,
tessa	PERSON,
ahahaha	PERSON,
derek	PERSON,
promot	ORGANIZATION,
nhl	ORGANIZATION,
ya	ORGANIZATION,
cbs	ORGANIZATION,
luce	PERSON,
shakara	PERSON,
champlin	PERSON,
counti	LOCATION,
winston	PERSON,
halen	PERSON,
swift	PERSON,
smallwood	PERSON,
bull	ORGANIZATION,
drum	ORGANIZATION,
wardlaw	ORGANIZATION,
rocki	ORGANIZATION,
monro	PERSON,
trip	PERSON,ORGANIZATION,
australia	LOCATION,
youtub	ORGANIZATION,
gold	ORGANIZATION,
stephani	PERSON,
hero	ORGANIZATION,
soni	ORGANIZATION,
kris	PERSON,
lal	PERSON,
moor	PERSON,
liberia	LOCATION,
dublin	LOCATION,
bed	ORGANIZATION,
pop	ORGANIZATION,
funki	ORGANIZATION,
arrey	ORGANIZATION,
alondra	PERSON,
spain	LOCATION,
rell	PERSON,
newson	PERSON,
westfield	ORGANIZATION,
sander	PERSON,
klein	PERSON,
minogu	PERSON,
los	LOCATION,ORGANIZATION,
great	ORGANIZATION,
pinion	ORGANIZATION,
jai	PERSON,
markballa	PERSON,
p.	PERSON,ORGANIZATION,
white	PERSON,
nadin	PERSON,
terraria	PERSON,
simpson	PERSON,
sabar	PERSON,
einstein	PERSON,
brisban	LOCATION,
righteous	PERSON,
liam	PERSON,
ive	PERSON,
lmfao	PERSON,
couz	PERSON,
rushen	PERSON,
roulett	ORGANIZATION,
el	LOCATION,
bonni	PERSON,
ivo	PERSON,
britt	PERSON,
dakota	LOCATION,
denis	PERSON,
andi	PERSON,
brown	PERSON,ORGANIZATION,
stoniethekid	PERSON,
toy	ORGANIZATION,
jimzub	PERSON,
beach	LOCATION,
mina	PERSON,
hairston	PERSON,
broco	PERSON,
chicago	LOCATION,ORGANIZATION,
lovato	PERSON,
romero	PERSON,
starbuck	ORGANIZATION,
houston	PERSON,
shaun	PERSON,
europ	LOCATION,
mahon	PERSON,
florida	LOCATION,
bond	PERSON,
levi	PERSON,
face	LOCATION,
eden	ORGANIZATION,
fiya	ORGANIZATION,
open	ORGANIZATION,
bethani	PERSON,
jerri	PERSON,
time	ORGANIZATION,
hapi	PERSON,
longo	PERSON,
bike	ORGANIZATION,
hour	ORGANIZATION,
athen	LOCATION,
bruno	PERSON,
keesha	PERSON,
hurley	PERSON,
itreal	ORGANIZATION,
beyonc	PERSON,LOCATION,
dumbledor	PERSON,
demp	PERSON,
abram	PERSON,
mcclendon	PERSON,
sleepova	PERSON,
estat	ORGANIZATION,
mann	PERSON,
angel	LOCATION,ORGANIZATION,
ryan	PERSON,
bay	PERSON,LOCATION,
flower	ORGANIZATION,
evan	PERSON,
lecra	PERSON,LOCATION,
morgan	PERSON,
canada	ORGANIZATION,LOCATION,
sann	PERSON,
karsh	PERSON,
lucia	PERSON,
dre	PERSON,
ost	ORGANIZATION,
kevin	PERSON,
meredith	PERSON,
virginia	LOCATION,
matt	PERSON,
swindel	PERSON,
chard	PERSON,
robina	PERSON,LOCATION,
burger	ORGANIZATION,
punk	ORGANIZATION,
danc	PERSON,
satankinani	PERSON,
slipknot	PERSON,
flo	PERSON,
oakwood	ORGANIZATION,
palestin	LOCATION,
keller	PERSON,
ashthon	PERSON,
del	PERSON,
natawni	PERSON,
lana	PERSON,
un	ORGANIZATION,
freddi	PERSON,
pataki	PERSON,
berri	PERSON,
mersey	ORGANIZATION,
ryanlounsburi	PERSON,
thailand	LOCATION,
mexico	LOCATION,
tom	PERSON,
franki	PERSON,
rockport	LOCATION,
corpor	ORGANIZATION,
ami	PERSON,
pennsylvania	LOCATION,
amazoncart	ORGANIZATION,
jillen	PERSON,
ise	ORGANIZATION,
ball	ORGANIZATION,
zina	PERSON,
jj	PERSON,
daniel	PERSON,
swon	ORGANIZATION,
tinertia	LOCATION,
yanke	ORGANIZATION,
ray	PERSON,
kennylovato	PERSON,
morton	PERSON,
gantt	PERSON,
mother	PERSON,ORGANIZATION,
monica	PERSON,
dinner	ORGANIZATION,
carson	LOCATION,
babi	PERSON,
rowland	PERSON,
ora	PERSON,
tayler	PERSON,
sambora	PERSON,
amg	ORGANIZATION,
mcbride	PERSON,
donni	PERSON,
luciano	ORGANIZATION,
beachwood	LOCATION,
gettin	PERSON,
lahor	LOCATION,
sabrina	PERSON,
michigan	LOCATION,
lano	PERSON,
luke	PERSON,
pacif	LOCATION,
disney	ORGANIZATION,
yama	PERSON,
aretha	PERSON,
justin	PERSON,
honeyboy	PERSON,
anna	PERSON,
amanda	PERSON,
pachuca	LOCATION,
winkl	PERSON,
stafford	ORGANIZATION,
sleepovaaaa	PERSON,
video	ORGANIZATION,
ceberano	PERSON,
usta	ORGANIZATION,
aden	LOCATION,
wallacemcconnel	PERSON,
lizzi	PERSON,
giggl	PERSON,
orlando	LOCATION,
phil	PERSON,
cage	PERSON,
barr	PERSON,
lilian	PERSON,
khloe	PERSON,
timecheck	LOCATION,
anouk	PERSON,
eliel	ORGANIZATION,
daddi	ORGANIZATION,
frickin	ORGANIZATION,
singleton	PERSON,
framklin	ORGANIZATION,
lookin	PERSON,
pakistan	LOCATION,
monaco	PERSON,LOCATION,
ashford	ORGANIZATION,
bahama	PERSON,
colin	PERSON,
bowi	PERSON,
program	ORGANIZATION,
brazil	LOCATION,
hendrickson	PERSON,
gotham	LOCATION,
yoxiam	PERSON,
livr	LOCATION,
art	ORGANIZATION,
calabasa	LOCATION,
keat	PERSON,
linkin	LOCATION,
keith	PERSON,
arbi	ORGANIZATION,
mawar	ORGANIZATION,
camron	PERSON,
yazoo	LOCATION,
cheri	PERSON,
slough	LOCATION,
nash	PERSON,
kierra	PERSON,
nicol	PERSON,
laney	PERSON,
littleton	LOCATION,
keef	PERSON,
mclemor	PERSON,
chariti	ORGANIZATION,
richi	PERSON,
halford	PERSON,
kelsey	LOCATION,
club	ORGANIZATION,
join	ORGANIZATION,
osteen	ORGANIZATION,
knope	PERSON,
waller	PERSON,
gladwel	PERSON,
jeida	PERSON,
tonio	ORGANIZATION,
musicstream	ORGANIZATION,
low	ORGANIZATION,
tarver	PERSON,
overcom	PERSON,
nfl	ORGANIZATION,
ford	PERSON,
capit	ORGANIZATION,
ferrari	PERSON,ORGANIZATION,
dj	ORGANIZATION,
bacquelain	PERSON,
california	LOCATION,
nicolai	ORGANIZATION,
ocean	LOCATION,
will	PERSON,
wingardium	PERSON,
pembrokeshir	LOCATION,
of	ORGANIZATION,
play	ORGANIZATION,
armond	PERSON,
manhattan	LOCATION,
mari	PERSON,
grizz	PERSON,
isi	ORGANIZATION,
bruh	PERSON,
yvonn	PERSON,
janeiro	ORGANIZATION,
asami	PERSON,
marinetti	PERSON,
suprem	ORGANIZATION,
jamesonxoxo	PERSON,
carr	PERSON,
pistorius	PERSON,
connect	ORGANIZATION,
ctv	ORGANIZATION,
zedd	PERSON,
mcconnel	PERSON,
thea	PERSON,
niver	PERSON,
heather	PERSON,
crescent	ORGANIZATION,
downey	PERSON,
pitbul	LOCATION,
ali	PERSON,
mehmet	PERSON,
woodstock	LOCATION,
kimmel	PERSON,
murphi	PERSON,
mitchacheson	PERSON,
bali	LOCATION,
ankela	PERSON,
tatum	PERSON,
hare	PERSON,
ymca	LOCATION,ORGANIZATION,
holetown	LOCATION,
georg	PERSON,
jami	PERSON,
standley	PERSON,
niven	PERSON,
dud	PERSON,
oscar	PERSON,
phoenix	PERSON,LOCATION,
backupifi	PERSON,
curt	PERSON,
north	LOCATION,
south	LOCATION,
wright	PERSON,
pharrel	PERSON,
bobbi	PERSON,
mariano	PERSON,
morgental	PERSON,
charli	PERSON,
us	ORGANIZATION,LOCATION,
yara	PERSON,
huntington	PERSON,
yay	PERSON,
michel	PERSON,
travi	PERSON,
holland	PERSON,LOCATION,
william	PERSON,ORGANIZATION,
jame	PERSON,LOCATION,ORGANIZATION,
shia	ORGANIZATION,
ou	ORGANIZATION,
beirut	LOCATION,
alaqsa	PERSON,
lyfe	LOCATION,
pitt	PERSON,
staind	LOCATION,
zealand	LOCATION,
emerson	ORGANIZATION,
portland	LOCATION,
hitler	PERSON,
yemen	LOCATION,
nkorea	ORGANIZATION,
littlebabytina	PERSON,
maddyleetham	PERSON,
hangin	PERSON,
mass	ORGANIZATION,
pizza	ORGANIZATION,
jenner	PERSON,
senat	ORGANIZATION,
miller	PERSON,
vixx	ORGANIZATION,
bryan	PERSON,
canton	PERSON,ORGANIZATION,LOCATION,
simon	PERSON,
colombia	LOCATION,
zach	PERSON,
famili	ORGANIZATION,
hayn	PERSON,
yahoo	ORGANIZATION,
osha	ORGANIZATION,
micah	PERSON,
american	ORGANIZATION,
saturn	ORGANIZATION,
victoria	LOCATION,
purpl	ORGANIZATION,
sia	ORGANIZATION,
ldr	ORGANIZATION,
banquel	PERSON,
daewon	ORGANIZATION,
model	ORGANIZATION,
audra	PERSON,
tayo	PERSON,
vatican	ORGANIZATION,
arabia	LOCATION,
carolina	LOCATION,
andrew	PERSON,
hawkey	PERSON,
fabio	PERSON,
todd	PERSON,
lavernecox	LOCATION,
clipper	ORGANIZATION,
maverick	ORGANIZATION,
consol	ORGANIZATION,
prefundia	LOCATION,
skygo	PERSON,
lasvega	LOCATION,
walmart	ORGANIZATION,
deitrick	PERSON,
countesthorp	ORGANIZATION,
ariga	PERSON,
lolo	ORGANIZATION,
lui	PERSON,
idiot	ORGANIZATION,
jeff	PERSON,
bell	ORGANIZATION,LOCATION,
kendal	PERSON,
calvin	PERSON,
instagram	PERSON,
wiggin	PERSON,
bob	PERSON,
hart	PERSON,
instrumentalmix	ORGANIZATION,
smith	PERSON,
blackeri	PERSON,
whatchu	PERSON,
action	ORGANIZATION,
bdnf	ORGANIZATION,
alexinimartini	PERSON,
control	ORGANIZATION,
wen	PERSON,
stanley	PERSON,
pricelin	ORGANIZATION,
listen	ORGANIZATION,
mcclurkin	PERSON,
johnson	PERSON,ORGANIZATION,
jay	PERSON,
elliott	PERSON,
tommaso	PERSON,
public	ORGANIZATION,
u.	LOCATION,
chef	ORGANIZATION,
deborah	PERSON,
railway	ORGANIZATION,
engram	PERSON,
buddhist	ORGANIZATION,
danni	PERSON,
jaqe	PERSON,
emc	ORGANIZATION,
devon	PERSON,
coastal	ORGANIZATION,
bradley	PERSON,
nashvill	LOCATION,
compani	ORGANIZATION,
avicii	LOCATION,
volcom	ORGANIZATION,
hud	PERSON,
adam	PERSON,
kati	PERSON,
solyndra	PERSON,
sandiego	PERSON,
chela	PERSON,
aberdeen	ORGANIZATION,
valencia	ORGANIZATION,
rebecca	PERSON,
easton	ORGANIZATION,
star	ORGANIZATION,
joel	ORGANIZATION,
rosado	PERSON,
india	LOCATION,
baker	PERSON,
pj	PERSON,
rita	PERSON,
the	ORGANIZATION,
cessa	PERSON,
oko	PERSON,
grey	PERSON,ORGANIZATION,
boe	ORGANIZATION,
jason	PERSON,
arlissa	LOCATION,
russel	PERSON,
pearl	LOCATION,
andria	PERSON,
ian	PERSON,
social	ORGANIZATION,
saint	ORGANIZATION,
moriah	PERSON,
megan	PERSON,
fast	ORGANIZATION,
billi	PERSON,
scott	PERSON,
cicim	PERSON,
byeeee	PERSON,
martin	PERSON,ORGANIZATION,
nelson	PERSON,
life	ORGANIZATION,
singapor	LOCATION,
palma	LOCATION,
petrucci	PERSON,
daisyllbak	PERSON,
lace	ORGANIZATION,
martina	PERSON,
maskin	PERSON,
bellini	PERSON,
judi	PERSON,
cunningham	PERSON,
cool	ORGANIZATION,
daili	ORGANIZATION,
tessman	PERSON,
reagan	PERSON,
key	ORGANIZATION,
donald	PERSON,
queen	ORGANIZATION,
in	ORGANIZATION,
inna	PERSON,
river	LOCATION,
sandstrom	PERSON,
nation	ORGANIZATION,
starlight	LOCATION,
st	LOCATION,
duke	PERSON,
whit	PERSON,
gift	ORGANIZATION,
dimitri	PERSON,
aketa	PERSON,
magic	ORGANIZATION,
malibu	LOCATION,
sim	PERSON,
iowa	LOCATION,ORGANIZATION,
roomi	PERSON,
mescalero	ORGANIZATION,
philippin	LOCATION,
matthew	PERSON,LOCATION,
karleeshagena	PERSON,
russia	LOCATION,
kyli	PERSON,
resort	ORGANIZATION,
rea	PERSON,
bubblew	PERSON,
edawn	ORGANIZATION,
dick	PERSON,
weech	PERSON,ORGANIZATION,
psat	ORGANIZATION,
lawson	PERSON,
pastaneleri	PERSON,
westbrook	PERSON,
lian	PERSON,
tamela	PERSON,
barett	PERSON,
west	LOCATION,
fmr	ORGANIZATION,
brighton	LOCATION,
condom	ORGANIZATION,
steven	PERSON,
madtown	PERSON,ORGANIZATION,
boda	PERSON,
norman	PERSON,
ash	PERSON,
intestin	ORGANIZATION,
pune	LOCATION,
detrick	PERSON,
krishna	PERSON,
businessweek	ORGANIZATION,
hoodi	PERSON,
parti	ORGANIZATION,LOCATION,
alexi	PERSON,
jackson	PERSON,ORGANIZATION,
coachmunsey	ORGANIZATION,
spm	ORGANIZATION,
mareo	PERSON,
trish	PERSON,
wendi	PERSON,
aleichem	PERSON,
pick	ORGANIZATION,
robert	PERSON,
egypt	LOCATION,
jong	PERSON,
arizona	LOCATION,
mercer	PERSON,
searci	PERSON,
harri	PERSON,ORGANIZATION,
angela	PERSON,ORGANIZATION,
co.	ORGANIZATION,
uwi	ORGANIZATION,
marathon	ORGANIZATION,
robin	PERSON,
neff	PERSON,
turkey	LOCATION,
arctic	ORGANIZATION,
bukowski	PERSON,
nichol	PERSON,
jammin	PERSON,
distophia	LOCATION,
anton	PERSON,
sapp	PERSON,
tye	PERSON,
tyron	PERSON,
jake	PERSON,ORGANIZATION,
tomi	PERSON,
inc	ORGANIZATION,
disneyland	ORGANIZATION,
jon	PERSON,
wong	PERSON,
yasss	PERSON,
help	ORGANIZATION,
rori	PERSON,
bahrain	LOCATION,
charl	PERSON,ORGANIZATION,
alisha	PERSON,
cna	ORGANIZATION,
json	PERSON,
wachusett	ORGANIZATION,
cadburi	ORGANIZATION,
derrick	PERSON,
leandria	PERSON,
jo	PERSON,
best	ORGANIZATION,
dope	ORGANIZATION,
rockin	PERSON,
zerb	ORGANIZATION,
jess	PERSON,
houghton	LOCATION,
shonda	PERSON,
mona	PERSON,
inc.	ORGANIZATION,
hardway	PERSON,
gilmor	PERSON,
curti	PERSON,ORGANIZATION,
festiv	PERSON,ORGANIZATION,
psl	ORGANIZATION,
mali	LOCATION,
usaf	ORGANIZATION,
salvador	LOCATION,
zacardi	PERSON,ORGANIZATION,
cortez	PERSON,ORGANIZATION,
mauric	PERSON,
kurt	PERSON,
jong-un	PERSON,
daft	ORGANIZATION,
sacbiz	LOCATION,
fox	PERSON,ORGANIZATION,
bitchez	PERSON,
nice	ORGANIZATION,
borri	PERSON,
lesli	PERSON,
fitzsimmon	ORGANIZATION,
made	ORGANIZATION,
sara	PERSON,
randi	PERSON,
amsterdam	LOCATION,ORGANIZATION,
photobooth	ORGANIZATION,
donna	PERSON,
elvi	PERSON,
stampley	PERSON,
lurcher	PERSON,
psk	ORGANIZATION,
cooper	PERSON,
sarai	PERSON,
hutchin	PERSON,
heathrow	LOCATION,
saaritaaa	LOCATION,
hs	ORGANIZATION,
fatima	ORGANIZATION,
woodsworth	LOCATION,
nevahurd	ORGANIZATION,
t.	PERSON,
cozumel	LOCATION,
ucsf	ORGANIZATION,
jarryd	PERSON,
appeal	ORGANIZATION,
noel	PERSON,ORGANIZATION,
street	ORGANIZATION,
demi	PERSON,
realtek	ORGANIZATION,
and	ORGANIZATION,
nichola	PERSON,
vashawn	PERSON,
hodg	ORGANIZATION,
tamara	PERSON,
blue	ORGANIZATION,
jagger	PERSON,
cutler	PERSON,
lawrenc	PERSON,ORGANIZATION,
rockabilli	ORGANIZATION,
walker	PERSON,
paisley	PERSON,
perri	PERSON,
riddhi	PERSON,
rey	PERSON,
hannah	PERSON,
allwin	PERSON,
valentino	PERSON,
mama	PERSON,
milk	ORGANIZATION,
patrick	PERSON,
cnn	ORGANIZATION,
desigu	ORGANIZATION,
laci	ORGANIZATION,
patricia	PERSON,
nicki	PERSON,
roslyn	PERSON,
kent	PERSON,
gautam	PERSON,
id	ORGANIZATION,
jessica	PERSON,
buckley	PERSON,
state	LOCATION,ORGANIZATION,
haze	ORGANIZATION,
eye	PERSON,
lexi	PERSON,
marien	PERSON,
bruci	PERSON,ORGANIZATION,
kenzo	PERSON,
heeeeyyyyy	PERSON,
alli	PERSON,
ballroom	ORGANIZATION,
iceland	LOCATION,
austin	PERSON,ORGANIZATION,LOCATION,
dreamforc	PERSON,
moniqu	PERSON,
nathan	PERSON,
king	ORGANIZATION,
lipp	ORGANIZATION,
guin	ORGANIZATION,
sittin	PERSON,
tini	ORGANIZATION,
mar	PERSON,
tori	PERSON,
dat	PERSON,
hiddleston	PERSON,
newman	PERSON,
show	ORGANIZATION,
rmr	ORGANIZATION,
eddi	PERSON,
seller	PERSON,
red	ORGANIZATION,
monterrey	LOCATION,
fair	ORGANIZATION,
ged	PERSON,
haa	PERSON,
diana	PERSON,
hannaford	LOCATION,
marco	PERSON,ORGANIZATION,
oomf	PERSON,
rajoy	PERSON,
human	ORGANIZATION,
new	ORGANIZATION,LOCATION,
givenchi	ORGANIZATION,
arthur	PERSON,
honor	PERSON,
dead	ORGANIZATION,
world	ORGANIZATION,
pink	ORGANIZATION,
eastwood	PERSON,
queeni	PERSON,
rocio	PERSON,
giveaway	ORGANIZATION,
stevi	PERSON,
wyom	LOCATION,
gari	PERSON,
edmond	PERSON,
retro	ORGANIZATION,
sausalito	LOCATION,
lord	PERSON,
bass	PERSON,
yayo	PERSON,
bullock	PERSON,
walkthemoonband	ORGANIZATION,
arkham	LOCATION,
sean	PERSON,
pringl	PERSON,
jobedu	PERSON,
tim	PERSON,
maccabe	ORGANIZATION,
moodi	ORGANIZATION,
potter	PERSON,ORGANIZATION,
seymour	PERSON,
doc	PERSON,
radio	ORGANIZATION,
workin	PERSON,
joinin	PERSON,
santorum	PERSON,
whoami	ORGANIZATION,
dulaney	PERSON,
group	ORGANIZATION,
hong	LOCATION,
dane	PERSON,
st.	ORGANIZATION,LOCATION,
hillaryclinton	PERSON,
food	ORGANIZATION,
alex	PERSON,
va	ORGANIZATION,
war	ORGANIZATION,
daniell	ORGANIZATION,
philli	LOCATION,
willet	PERSON,
sholem	PERSON,
polic	ORGANIZATION,
blessing-shari	PERSON,
las	LOCATION,
granni	PERSON,
grove	LOCATION,
perth	LOCATION,
filippo	PERSON,
teen	ORGANIZATION,
roger	PERSON,
ubc	ORGANIZATION,
hell	LOCATION,ORGANIZATION,
byu	ORGANIZATION,
dan	PERSON,
mobli	LOCATION,
aiden	PERSON,
amherst	LOCATION,
meet	ORGANIZATION,
marouli	PERSON,
cedric	PERSON,
romeo	PERSON,
channin	PERSON,
deutsch	PERSON,
stavang	LOCATION,
ima	PERSON,
heart	ORGANIZATION,LOCATION,
poet	ORGANIZATION,
crawfordsvill	LOCATION,
unit	LOCATION,ORGANIZATION,
petti	PERSON,
barnaba	PERSON,
answer	ORGANIZATION,
wten	ORGANIZATION,
abuja	LOCATION,
davi	PERSON,
bush	PERSON,
cobb	PERSON,
riversid	ORGANIZATION,
ason	PERSON,
birdi	PERSON,
coolio	ORGANIZATION,
minelli	PERSON,
ruslan	PERSON,
wawancara	ORGANIZATION,
benson	PERSON,
yate	PERSON,
skrillex	LOCATION,
lelo	ORGANIZATION,
mandisa	PERSON,
41	ORGANIZATION,
airi	LOCATION,
kravet	ORGANIZATION,
kathleen	PERSON,
pbr	ORGANIZATION,
grabe	PERSON,
denni	PERSON,
turin	LOCATION,
yoria	PERSON,
villag	LOCATION,
pam	ORGANIZATION,
portia	PERSON,
jona	PERSON,
carr-th	PERSON,
hilton	LOCATION,ORGANIZATION,
kitchen	LOCATION,
for	ORGANIZATION,
ayer	PERSON,
megabus	ORGANIZATION,
jone	PERSON,ORGANIZATION,LOCATION,
jenna	PERSON,
uysal	PERSON,
krit	PERSON,
stevenson	PERSON,
paul	PERSON,
rino	ORGANIZATION,
golden	PERSON,
riyadh	LOCATION,
trusseau	PERSON,
espn	ORGANIZATION,
griffin	PERSON,
smh	ORGANIZATION,
mayfair	LOCATION,
minnesota	LOCATION,
triumfant	PERSON,
erica	PERSON,
keyston	ORGANIZATION,
gibraltar	LOCATION,
kirstyemoseley	PERSON,
law	ORGANIZATION,
labeouf	ORGANIZATION,
jamaica	LOCATION,
annabell	PERSON,
brenda	PERSON,
newark	LOCATION,
walli	PERSON,
toshiba	ORGANIZATION,
chasiti	PERSON,
abigail	PERSON,
hoofin	PERSON,
snoop	PERSON,
jeremiah	PERSON,
nuthin	LOCATION,
poland	LOCATION,
guthri	PERSON,
heheh	PERSON,
sneed	PERSON,
carl	PERSON,
bbc	ORGANIZATION,
jalissagarza	LOCATION,
dream	ORGANIZATION,
charlott	LOCATION,
lamont	PERSON,
altidor	PERSON,
jekalyn	PERSON,
dolmeth	PERSON,
fabfitfun	PERSON,
drievyf	PERSON,
pharel	ORGANIZATION,
taser	ORGANIZATION,
ac	ORGANIZATION,
livin	PERSON,
langdon	PERSON,
york	ORGANIZATION,LOCATION,
ft.	PERSON,ORGANIZATION,
madonna	PERSON,
samsung	ORGANIZATION,
antibala	PERSON,
hopkin	PERSON,
popper	PERSON,
lisbon	LOCATION,
ella	PERSON,
seger	PERSON,
chozen	LOCATION,
helen	PERSON,
minaj	PERSON,
label	ORGANIZATION,
nostalgianmor	PERSON,
reggi	PERSON,
underdog	PERSON,
raph	PERSON,
watkin	PERSON,
note	ORGANIZATION,
mall	ORGANIZATION,
ariana	PERSON,ORGANIZATION,
jesus	PERSON,
henderson	PERSON,
pattaya	LOCATION,
yahuah	ORGANIZATION,
yedlin	PERSON,
tolt	LOCATION,
bros	PERSON,
constantin	PERSON,
deca	ORGANIZATION,
makin	PERSON,
buycottapp	PERSON,
torri	PERSON,
melini	PERSON,
moustaka	PERSON,
ari	PERSON,
grainger	LOCATION,
lacson	ORGANIZATION,
taco	ORGANIZATION,LOCATION,
mando	PERSON,
gile	PERSON,
groufi	PERSON,
jxxssica	PERSON,
jimmydurano	PERSON,
etobicok	LOCATION,
hua	ORGANIZATION,
matin	PERSON,
fred	PERSON,
lopez	PERSON,
dee	PERSON,
fuego	PERSON,
bubba	PERSON,
monkey	ORGANIZATION,
seoul	LOCATION,
magoo	PERSON,
leagu	ORGANIZATION,
beij	LOCATION,
santiago	PERSON,
bechah	PERSON,
eagle-ey	LOCATION,
tommi	PERSON,
dsm	ORGANIZATION,
pluit	LOCATION,
winan	PERSON,
wembley	LOCATION,
electronicsnew	ORGANIZATION,
surrey	ORGANIZATION,
m.	PERSON,
batman	PERSON,
fredrick	PERSON,
memori	ORGANIZATION,
uk	LOCATION,
brad	PERSON,
timberlak	PERSON,
fcb	ORGANIZATION,
margat	ORGANIZATION,
lazer	ORGANIZATION,
fli	ORGANIZATION,
rayvon	PERSON,
ben	PERSON,
rector	PERSON,
bsm	ORGANIZATION,
avril	PERSON,
gareth	PERSON,
probz	PERSON,
dobi	ORGANIZATION,
neobux	ORGANIZATION,
lipstick	ORGANIZATION,
tati	PERSON,
cook	PERSON,
mandinka	LOCATION,
haley	PERSON,
hailey	PERSON,
gavin	PERSON,
cloth	ORGANIZATION,
citi	LOCATION,ORGANIZATION,
footscray	LOCATION,
knowl	ORGANIZATION,
motherf	PERSON,
romanthoni	PERSON,
edwin	PERSON,
jose	PERSON,
zed	PERSON,
rolo	PERSON,
delmon	PERSON,
s.	PERSON,
naaziah	PERSON,
beth	PERSON,
brian	PERSON,
siwfraney	PERSON,
rose	PERSON,
night	ORGANIZATION,
joerobertcollin	PERSON,
paig	PERSON,
liverpool	LOCATION,
stormchas	PERSON,
tfw	PERSON,
alright	PERSON,
wayn	PERSON,LOCATION,
kandi	LOCATION,
sperri	PERSON,
dubai	LOCATION,
caesar	PERSON,
jingl	ORGANIZATION,
arkansa	ORGANIZATION,
wonder	PERSON,
frankiiiieee	PERSON,
iol	ORGANIZATION,
milf	ORGANIZATION,
godkid	PERSON,
kean	ORGANIZATION,
reev	PERSON,
olli	PERSON,
smart	PERSON,
joe	PERSON,
chester	PERSON,
hiphop	ORGANIZATION,
kong	LOCATION,
oldi	ORGANIZATION,
peter	PERSON,
jonahmarai	PERSON,
madrid	LOCATION,
stoner	PERSON,
steri	ORGANIZATION,
godaddi	ORGANIZATION,
isaac	PERSON,
cleveland	ORGANIZATION,
moss	PERSON,
fama	PERSON,
bon	LOCATION,
arianagrand	PERSON,
desmond	PERSON,
grae	PERSON,
reedi	PERSON,
jr	PERSON,
town	ORGANIZATION,LOCATION,
impala	ORGANIZATION,
georgia	ORGANIZATION,LOCATION,
clair	PERSON,
sticker	ORGANIZATION,
cynthia	PERSON,
zizzi	PERSON,
thorp	PERSON,
usa	LOCATION,
moab	LOCATION,
rainey	PERSON,
velcro	PERSON,
instrument	ORGANIZATION,
ukvib	LOCATION,
gervai	PERSON,
tumbridg	LOCATION,
school	ORGANIZATION,
la	ORGANIZATION,
peralta	PERSON,
text	ORGANIZATION,
now	ORGANIZATION,
nascar	ORGANIZATION,
gaston	PERSON,
eleanor	PERSON,
neeko	ORGANIZATION,
juan	PERSON,
chris	PERSON,
sugar	PERSON,
haiuthegod	PERSON,
siri	PERSON,
utah	LOCATION,
barclay	ORGANIZATION,
dogg	PERSON,
real	ORGANIZATION,
bookinneverland	ORGANIZATION,
flanagan	PERSON,
upcycl	ORGANIZATION,
ntho	PERSON,
santa	LOCATION,
indiana	LOCATION,
leshea	PERSON,
joey	PERSON,
bradi	PERSON,
mial	ORGANIZATION,
shirley	PERSON,
anberlin	LOCATION,
jel	PERSON,
ameen	PERSON,
hezekiah	PERSON,
parham	PERSON,
nike	ORGANIZATION,
sheard	PERSON,
xoxo	ORGANIZATION,
syria	LOCATION,
steve	PERSON,
shawn	PERSON,
idol	PERSON,
seattl	LOCATION,
samantha	PERSON,
marvin	PERSON,
pappi	PERSON,
woodward	PERSON,
applebe	ORGANIZATION,
america	LOCATION,
indonesian	LOCATION,
malaysia	LOCATION,
pa	LOCATION,
gabor	PERSON,
dave	PERSON,
satriani	PERSON,
beck	PERSON,
motorcycl	ORGANIZATION,
iii	PERSON,
don	PERSON,
ronald	PERSON,
societi	ORGANIZATION,
jr.	PERSON,
lavign	PERSON,
ministri	ORGANIZATION,
mae	PERSON,
histori	ORGANIZATION,
richard	PERSON,
belfast	LOCATION,
elsa	PERSON,
sonica	PERSON,
musanz	LOCATION,
cherri	LOCATION,
run	LOCATION,
ppl	ORGANIZATION,
jam	LOCATION,
dasha	PERSON,
farruko	LOCATION,
geoffrey	PERSON,
giant	ORGANIZATION,
hongkong	ORGANIZATION,
mccoy	PERSON,
men	ORGANIZATION,
jersey	LOCATION,ORGANIZATION,
neumann	PERSON,
emma	PERSON,
grangersmith	PERSON,
elton	ORGANIZATION,
spight	PERSON,
allen	PERSON,
hammond	PERSON,
bintan	LOCATION,
isl	LOCATION,
emili	PERSON,
mbc	ORGANIZATION,
jeremi	PERSON,
phototom	ORGANIZATION,
foodnew	ORGANIZATION,
fortun	PERSON,ORGANIZATION,
chelsea	ORGANIZATION,
edward	PERSON,
kimbra	LOCATION,
antwuan	PERSON,
tennesse	LOCATION,
lisa	PERSON,ORGANIZATION,
huffington	ORGANIZATION,
lolasnaturalbotan	PERSON,
wagner	PERSON,
addison	PERSON,
tyson	PERSON,
sinclar	PERSON,
tripp	PERSON,
u.s.	LOCATION,
bounc	ORGANIZATION,
jenkin	PERSON,
jada	PERSON,
oman	LOCATION,
korea	LOCATION,
electr	ORGANIZATION,
ramsey	PERSON,
greec	LOCATION,
kb	ORGANIZATION,
jimmi	PERSON,
galaxi	ORGANIZATION,
grace	PERSON,ORGANIZATION,
kmart	LOCATION,
miguel	LOCATION,
mitchel	PERSON,ORGANIZATION,
olivia	PERSON,
tech	ORGANIZATION,
grammer	PERSON,
metallica	ORGANIZATION,
